*********X
*X****XX**
*X*X*****X
XX*X*X**XX
***X*X*X**
*X*X*XX**X
*******X**
XX*XXX*X*X
***X******
*XXXXXXXX*